11111111111111111111111111111111111
1000000000000C000000000000000000001
10100000010101V010100101000100000E1
101V00101010100C00000C00000000C0011
101000101010100C00001000000V0010001
1010101C10101001V100101000010100001
10100101010010100101010000101100101
1000000P0V000C000101010100C00C00001
11111111111111111111111111111111111